-BidRequestType brt 借款类型
icon	String	图标
name	String	名称
feature	String	特征描述

-MOD paymentWay 还款方式
PAYMENT_WAY_AVERAGE_CAPITAL	等额本金
PAYMENT_WAY_AVERAGE_CAPITAL_PLUS_INTEREST	等额本息
PAYMENT_WAY_FIRST_INTEREST_LAST_CAPITAL	先息后本
PAYMENT_WAY_DUE_CAPITAL_PLUS_INTEREST	到期本息

-MOD prerequisite 借款条件
PREREQUISITE_BASE_AUTHENTICATION	基本认证
PREREQUISITE_UPLOAD_STUFF	上传材料
PREREQUISITE_REGISTER_VIP	申请 VIP
PREREQUISITE_PRIVILEGED	特权（保证）标识

-MOD process 基本流程
PROCESS_AUTO_PUBLISH	自动发布
PROCESS_AUTO_BID	自动投标
PROCESS_AUTO_FIRST_AUDIT	自动初审
PROCESS_AUTO_LAST_AUDIT	自动终审
PROCESS_AUTO_REPAY	自动还款
PROCESS_AUTO_ADVANCE	自动垫付

-MOD specialProcess 特殊流程
SPECIAL_PROCESS_REPAY_AFTER_LAST_AUDIT	即时还款
SPECIAL_PROCESS_FREEZE_BORROW_CHARGES	冻结借款费用

-MOD charges 收费情况
CHARGES_BORROW_MANAGEMENT_CHARGES	借款管理费
CHARGES_LOAN_MANAGEMENT_CHARGES	投资管理费
CHARGES_OVERDUE_PAYMENT_SURCHARGE	逾期滞纳金

-MOD advance 垫付情况
ADVANCE_CAPITAL	颠覆本金
ADVANCE_INTEREST	颠覆利息

-MOD mods 位状态
MODS_CAN_EXPERIENCE	是否可体验